2 1
00000000000000000000000000
01111111111111111111111110
0                        0
033        222222      330
0                        0
0                        0
0     333        333     0
0                        0
0                        0
0         222          220
0         1b1           p0
00000000000000000000000000
