3 14
000000000000000000000000
01111             111110
033333333333333        0
03333333333333333      0
00002211111111111      0
0                      0
0                      0
0                 111110
0       333            0
0       3b32           0
0       3332         110
000000               110
0000                   0
00                    p0
000000000000000000000000
