*******************************
*                             *
*                             *
*                             *
*                             *
*                             *
*                             *
*                             *
*                             *
*                             *
*                             *
*                             *
*                             *
*                             *
*                   **        *
*                             *
*                             *
*                             *
*                             *
*                             *
*                             *
*                             *
*           ***               *
*                             *
*                             *
*                             *
*     *****                   *
*      *****                  *
*                             *
*                             *
*                             *
*******************************