*******************************
*                             *
*      **                     *
*      **                     *
*      **                     *
*      **                     *
*                             *
*                             *
*                             *
*                             *
*             ***             *
*                *****        *
*                             *
*                             *
*                             *
*                             *
*                             *
*                             *
*                             *
*                             *
*                             *
*           ****              *
*                             *
*                             *
*                             *
*                             *
*                             *
*                             *
*                             *
*                             *
*                             *
*******************************
